
R 1000 1000

NO ./texture/wall1.xpm
SO ./texture/wall2.xpm

WE ./texture/wall3.xpm



EA ./texture/wall5.xpm
S ./texture/sprite.xpm

F 225, 15, 0
C 0, 0, 255  

        1111111111111111111111111
        1002222000110200200000201
        1011200201111120002002001111111
        1001002111111202002000000100001
1111111110110N0111100111111200021111111
100000000011000111111111110111111
11110111111111011100000010001
11110111111111011101010010001
11000000110101011100000010001
10000200000000001100000010001
10000000000000001101010010001
1100000111010121111101111000111
11110111 1110101 101111010001
11111111 1111111 111111111111


